{
  "42": [
    [0,0,0,0,0,0,0,0,0,0,0,0,0,0,0,0,0,0,0],
    [0,0,0,0,0,0,0,0,0,0,0,0,0,0,0,0,0,0,0],
    [0,0,10,10,0,0,10,10,0,0,0,10,10,10,10,10,0,0,0],
    [0,0,10,10,0,0,10,10,0,0,0,0,0,0,0,10,10,0,0],
    [0,0,10,10,0,0,10,10,0,0,0,0,0,0,0,10,10,0,0],
    [0,0,10,10,10,10,10,10,0,0,0,0,10,10,10,10,0,0,0],
    [0,0,0,10,10,10,10,10,0,0,0,10,10,0,0,0,0,0,0],
    [0,0,0,0,0,0,10,10,0,0,0,10,10,0,0,0,0,0,0],
    [0,0,0,0,0,0,10,10,0,0,0,10,10,10,10,10,10,0,0],
    [0,0,0,0,0,0,0,0,0,0,0,0,0,0,0,0,0,0,0],
    [0,0,0,0,0,0,0,0,0,0,0,0,0,0,0,0,0,0,0]
  ],
  "pyramid": [
    [0,0,0,0,0,0,0,0,0],
    [0,1,1,1,1,1,1,1,0],
    [0,1,2,2,2,2,2,1,0],
    [0,1,2,3,3,3,2,1,0],
    [0,1,2,3,4,3,2,1,0],
    [0,1,2,3,3,3,2,1,0],
    [0,1,2,2,2,2,2,1,0],
    [0,1,1,1,1,1,1,1,0],
    [0,0,0,0,0,0,0,0,0]
  ],
  "mars": [
    [0,2,0,2,0,2,0,2,0,2,0,2],
    [2,4,2,4,2,4,2,4,2,4,2,4],
    [0,2,0,2,0,2,0,2,0,2,0,2],
    [2,4,2,6,2,6,2,6,2,4,2,4],
    [0,2,0,2,0,2,0,2,0,2,0,2],
    [2,4,2,4,2,8,2,8,2,4,2,4],
    [0,2,0,2,0,2,0,2,0,2,0,2],
    [2,4,2,4,2,6,2,6,2,4,2,4],
    [0,2,0,2,0,2,0,2,0,2,0,2],
    [2,4,2,4,2,4,2,4,2,4,2,4],
    [0,2,0,2,0,2,0,2,0,2,0,2],
    [2,4,2,4,2,4,2,4,2,4,2,4]
  ]
}
